XXXXXXXXXXXXXXXXXXXXXXXXXXXXXXXXXXXXXXXXXXXXXXXXXX
XS0000X000000000000000000X00000000000000000000000X
X00000X0000000000000XX000X000XXXXXXXXXXXXX0XXXXXXX
X0XXX00000000000000000000X000000000X00000X0000000X
X00000X00000X0000XX000000X000000000X0X000X00000X0X
X0000000XXXXX000000000000X000XXXXXXX0X000X00000X0X
X0XXXXX00000X000000000000X000000000X0X000X00000X0X
X00000000000X000XXXXXXXXXX00000000XX0X000X00000X0X
X00000000000X000000X00000X00000000X00X000X00000X0X
X00X00000000X000X00000000X00000000X00X000000000X0X
X00X00000000000XX00X00000X00000XXXX00XXXXXXXXXXX0X
X00X00XXXXXXX00000000XX00X00000X00000000000000000X
X00X00000000X000X00X00000X0000XX0XXXXXXXXXXXXXXXXX
X00X00000000XXXXXXXXXXX0XX000XX0000000000X0000000X
X00X000000000000000X00000X000X00XXXXXXXX0X0000000X
X00XX00000000000000X0000XX00XX000000000X0X0000000X
X00X00000000000000000000X000X0000000000X0X0000000X
X00X0000X000000000000000X000X0000000000XGX000X000X
X00X0000XXXXXXXXXXXX00000000XX000000000XXX000X000X
X00X0000X000000000XX000000000X000000000000000X000X
X00X0000X0000X0000XXXXXXXXXXXXXXXXXXXXXXXXXXXX000X
X00XXXXXXX000X000000000000000000000000000XXXXX000X
X000000000000XXXX00000000X00000X00X0000000XXXX000X
X0X00000X0000000X00000000X0000XXXXXXX000000000000X
XXXXXXXXXXXXXXXXXXXXXXXXXXXXXXXXXXXXXXXXXXXXXXXXXX